99 99
###################################################################################################
#.....................................#.....#.......#.................#...........#.......#.....#.#
###########################.###########.###########.#################.#########.#.#.#.#.###.#.#.#.#
#.........#.#.#...#...#...#.#.#.#.....#.#...#.......#.#.......#...#.#.#.....#...#.#.#.#...#.#.#.#.#
#.#.#.#####.#.#.#.#.#.###.#.#.#.#.#.###.#.#########.#.#.#.#.#.#.#.#.#.###.###.#.#.#.#.#.#.#.#.#.#.#
#.#.#...........#...#.......#.#.#.#...#.....#.......#...#.#.#.#.#.#.#.#.....#.#.#.#.#.#.#.#.#.#.#.#
###################.#######.#.#.###.#######.#.#.#.#.###.#########.#.#.#####.###.#.#.#.#####.###.#.#
#...................#...........#...........#.#.#.#.#.........#.#.#.#.#.#...#...#...#.........#.#.#
#############################.#######.#######.#.#.#.#.#########.#.#.#.#.#.#.#.#########.###.#.#.#.#
#...............................#...........#.#.#.#.#.........#...#.#.#...#.....#.....#...#.#.#.#.#
#.#.###.#.#####.#.#.#############.#######.###.#####.#########.#.###.#.###########.###.#.#.#.#.#.#.#
#.#.#...#.....#.#.#.............#.#.........#.#.#.#.#.........#.....#.#...#.#.#...#.....#.#.#.#.#.#
#.#####################################.#####.#.#.#.#.#.#.###.#.###.#.#.#.#.#.#################.#.#
#.#.....#.........#.....#...#...#...........#.#.....#.#.#...#...#.......#.........................#
#.#.#############.#.#######.###.###########.#######.#.#############################################
#.......#.............#.#...#...#.......#...#.....#.#.#...#.#.#.....#.#.#...#...#.#...#...........#
#####.#.#######.###.#.#.#.#.#.###.#.###.#.#####.###.#.#.#.#.#.#.#####.#.###.#.#.#.###.#.###########
#...#.#...#.......#.#...#.#.#...#.#.#...#...#.......#...#.....#...............#.#.#...#.....#.....#
#.#.#.#.#.#.###########.#.#.#.#########.#.#.#.#########.###.###.#.###.#####.###.#.#.###.###.###.###
#.#...#.#.............#.#.#.#.............#.............#.......#...#.....#...#...........#.......#
#####################.#.#.#.###.#.#.###############################################################
#.#.#.....#...........#.#.#.#...#.#.#.........#.#.................................................#
#.#.#####.#####.#.#####.#.#.###.#.#.###.###.#.#.#####.#.###.#######################################
#.#.#.....#.....#.#...#.#.#.....#.#.....#...#.........#.#.............#...............#.#.....#.#.#
#.#.#####.#####.#.#.#.#.#.###########################################.#####.#####.#####.#####.#.#.#
#...#.#...#.....#...#.#.........#.............................................#.......#.#.........#
#.###.#.###########################################################################.###.###.#######
#.#.#.....#.....#.....#.........#.#.#.........#...#.......#.#.................#.#...............#.#
#.#.#.#####.###.###.#.#.#########.#.#####.#.#.#.#.#####.###.#.###############.#.#.#.#####.#####.#.#
#...#.....#...#.#...#.#.#.....#.#...#.....#.#...#...............#.#...........#.#.#.#.........#...#
###.#####.#.###.#.#.#.#.###.#.#.###.#.#####################.#.#.#.#.###########.#.###############.#
#...#.#.#.#...#.#.#.#.#.#...#...#...#...#.#.......#.........#.#.#.................#.............#.#
###.#.#.#.#.#######.#.#.#.###.#.#.#.#.#.#.#.###.#####.#############################.#.#.#####.###.#
#...#.#...#.#.......#.......#.#...#...#...#...#...................................#.#.#.#...#...#.#
#.###.###.#.#.#####################################################################.###.#.#####.#.#
#...#.#...#.#.#.........#.#...........#.#...#...#.......#.#...#...#.........#.#...#...#.....#...#.#
#.###.###.#.#.#.#.###.#.#.#.#.###.###.#.###.###.#.#####.#.#.###.#########.#.#.#.#.#####.#########.#
#...#.....#.#...#...#.#...#.#...#...#...#...#.#.#.#.#.....#...#...#.......#.....#.#.#...#.#.......#
###.#.#####.#.#####.#.#.###.###########.#.#.#.#.#.#.###.###.###.#######.###########.#.###.#.#.###.#
#...#.....#...#.....#.#...#...#.#.......#.#...#.#.#.#.#...#.#.#.........#.#.#.....#.#.#.#.#.#...#.#
###.###.###.###.#####.#.#.###.#.#######.#.###.#.#.#.#.#.#.#.#.#########.#.#.#.#####.#.#.#.#.#.#####
#...#...#...#.#.....#.#.#.#...#.#.#.......#...#.#.#...#.#.#.#.......#.........#.#.#.#...#...#...#.#
#.#.#.###.###.#####.###.#.###.#.#.#.#####.#.#.#.#.###.#.#.#.#######.#.#####.#.#.#.#.###.###.#.#.#.#
#.#.#.#.......#.....#...#.......#...#.....#.#.....#...#.#.#.....#...#...#...#.#.#.#.........#.#...#
###.#.#.###.#######################################.#.#.#.#.###.#.#.#.#.#####.#.#.#####.###########
#.......#.......#.................................#.#...#...#.....#...#.#.........#...............#
###.#########.#.#.#################################################################################
#.........#...#...............................................#.#...........#.#...#.#.........#.#.#
#########################################################.###.#.#.#.#####.###.#.###.#########.#.#.#
#.....#...#.#.#...#.#...#.#.....................#...........#.....#.....#...#.#...#.#.........#...#
#####.#.#.#.#.###.#.###.#.#####################.#####.#####.#.#####.#.#######.#.###.###.#.#.#.###.#
#.#.#.#.#.#.#.#.........#.#...#...#.#...........#.#...#...#.#.....#.#...#.#.#.....#.#...#.#.#.....#
#.#.#.#.#.#.#.#########.#.#.#.###.#.###########.#.#.###.###########.###.#.#.#.#####.#.#######.#####
#.#.....#.....#.....#...#.#.#.......#...........#.#...#.#...........#.....#.#...#.#.#.......#.....#
#.#.#.#######.###.#.###.#.#.#######.###########.#.#.#.#.#.#####.#####.#.#.#.###.#.#.#.#######.#.###
#...#...#.....#...#.....#.#.#.#...#.#...........#...#...#.....#.....#.#.#.#.#.......#.......#.#.#.#
#############.#.#########.#.#.#.###.#.#########.###.#####.#####.###.#.#.#.#.###.###.#.#.#####.###.#
#.#.....#...#.#.......#.#...#.............#.............#.#...#.#.#.#.#.#.#.#.....#.#.#.#...#.....#
#.#.#.###.###.###.#.#.#.#########################.###.###.#.#.#.#.#.#.#.#.#.#.#####.#.#.#.#######.#
#...#...#.....#...#.#...#.....................#.#.#.#...#...#.#...#.#.#.#.#.#.....#.#.#...#.#.....#
#####.#.#.#####.###.#.###.###################.#.#.#.#.#.#.###.#.###.#.#.#.#.###.###.#.#.#.#.#####.#
#.#...#.#.....#...#.#...#.#.........#...#...#.#.....#.#.#.#.#.#...#.#.#.#.#.#...#.....#.#.#.#.....#
#.#.#####.#############.#.#.#######.#.#####.#.#######.###.#.#.#.#########.#.#############.#.#.#####
#.#...#.........#...#...#.#.#.#.....#.........#...#.#...#.#...#.....#.#...#.#...............#.....#
#.#.#.#.#####.#.###.#.###.#.#.###.#.###.###.#.###.#.#.###.#.#.#####.#.#.#.#.#.#.###################
#...#...#.....#.#...#.#...#...#...#.....#...#.#.........#.#.#.#.....#...#.#.#.#.......#.......#...#
#.#.#.###.#.###.#.#.#.#.#.###.#.#.#####.###############.###.###.#.#######.#.#.#.#####.#.#.#.#.###.#
#.#.#.#...#...#...#.....#.#...#.#.#.....................#.....#.#...#.........#.#.......#.#.#.#.#.#
#############################################################################################.#.#.#
#...................................................................#.#...........................#
###############################################################.#####.#.###########################
#.......#.......#.........................#.....#...........#.#...#.#.#...........................#
#.#######.#.#############################.#.#####.#.#######.#.#.###.#.#.#.#######################.#
#.#...#.#.#.....#...................#.....#.....#.#.......#.#.#.#.#.#.#.#.#...............#.#.#...#
#.#.###.#.#######.#######.#.#.#.#.#.#.#.#.#####.#######.#####.#.#.#.#.#.#.#############.#.#.#.#.#.#
#.......#.#.#...#.#.......#.#.#.#.#...#.#.#.....#.#.#...#...#.#.....#...#.#.............#.......#.#
###.###.#.#.###.#.#######################.#####.#.#.###.#.#.#.#.#.#######.#####.###################
#.....#.#.#.....#.#...........#.#.....#...#.......#.#.....#.#.#.#...#.#...#...........#.#...#.#.#.#
#.#######.#.#####.#####.#####.#.###.#.#.#####.###.#.#####.#.#.#.#.###.###.#.#.#.###.#.#.#.#.#.#.#.#
#.......#.#...#.#.#.......#.........#.....#.....#.....#...#.#.#.#...#.#...#.#.#...#.#.....#...#.#.#
###.#.#.#.#.#.#.#########.###############.#.#####.#.#.#.#.#.#.#.#.#.#.###.#.#.#.#.#######.#.#.#.#.#
#.#.#.#.#...#.#.#.........#.............#.#.#...#.#.#...#.#.#.#.#.#.#.#...#.#.#.#.#.......#.#.....#
#.#.#.#.#.#.#.#.###################.#####.#.#.#.#.#########.#.#####.#.###.#######.###.#############
#.#.#.#.#.#.#.#.#.#.....#.#.#...#.............#.#.#...................#...#.....#.#.......#.......#
#.#.#####.#.###.#.###.#.#.#.#.#.#####################################.###.###.###.#####.#.###.###.#
#.......#.#...#...#...#.......#.#...#...#...#...#...#.......#.#.#.#.#.#...#.......#.#...#.#.....#.#
#.#######.###.#.#####.#########.###.#.###.###.###.#.#.#.###.#.#.#.#.#.#.###.###.#.#.#.###.#.#.###.#
#...#...#.#...#.#.#...#.#.......#.#.#.#.#.........#...#...#...............#.#...#.#.....#...#...#.#
#.#####.#.#.#.#.#.#.###.#######.#.#.#.#.#.#.#.#.#.#################################################
#.#.#.#.#.#.#.#...#...#.#...#...#...#...#.#.#.#.#.....#.....#...#...#...............#.....#.......#
#.#.#.#.#.###.#.#####.#.#.#.#.#####.#.###.#######.###.#.###.#.#.#.#.#.###.#.#.#.#.###.###########.#
#.#.#...#.#...#.......#.#.#.#...#...#...#.#.........#...#.....#...#...#...#.#.#.#.................#
#.#.#.#.#.###.#####.#.#.#.#.###.#.#.###.#.###.###############.#######.#.###########################
#.....#.#.#.#.#.....#.#.#.#.....#.#.#...#.#.........#.........#.......#...........................#
#.#######.#.#.#.###.###.#.#######.#.#.###.#######################################################.#
#.......#.#...#.#.....#.#.......#.#.....#.#.#...#.................#.......#...#.....#.#.........#.#
#####.#.#.###.#.#.#####.###.#.###.#.#.###.#.#.#.###############.#.###.###.#.###.#.###.###.#####.#.#
#.....#...#.....#.....#.....#.....#.#.....#...#.................#.....#.........#.............#...#
###################################################################################################
